11111111111111011111111111111
00000000000001000001000100010
01110111111111011101010101010
00010001000000000100010001010
11011101011111110111111101010
00010001000100010000000101010
11110111011101011111010101010
00000100010001000000010101000
01111101110101110111110101111
00000001000100010100010101000
11111111011111011101110101010
00000001010001000100010100010
01010111010101110111010111110
01010001010100010000010001010
01011101010111011111111101010
01000100000001010000000101000
11110111111101110111110101111
00010100010000000100010101000
01011101010111111101010101010
01010001010000000101010100010
01010111110111110101011111110
01010100010001000101000001000
01010101011101011111011101011
01000101010001000001000101000
01111101011111111101010111110
00000101000100010001010100010
01110101110101010111110101010
01000101000101000100010101010
01011101011101111101010101110
01000101010000000001000100010
01011101110111111111011101010
01000100000100000001000101000
01110111111101111101110111111
01000100000001000001010000000
01011111111101011111010111110
01000100010001010001000100010
01110101010111010111011101011
01000101010001000100010001000
01111101010101111101110111110
01000001010101000101000001000
01010111010101010101111101011
00010001010101010100000001010
01111101010101011101111111010
00010001000101010001000001010
11110111110111010101011101010
00000100010100010101000101010
01111101110101110101010111010
00000100010100000101010001010
11110101010111111111010101010
00010101010001000100010101000
01010111010111010101011101011
01000000010000010001010000000
11111111111111111111110111111
