11111111111111111111111111111111110
01000000010000000100000100000000010
01011111010111011111011101110111010
00000001000101000001000001010100010
11110101111101111101110101010111110
00010100000001000001010101010000010
01011111110101011111011101011111010
01000000010101000100000100000100010
01111111011101110101110111110101110
00000100010100010100010000010100000
01110111010111010111110101010111111
00010001010100010001000101010001000
11111101010101111101011101011101110
00000101000001000101000101000100000
01110101111101110101110111011111110
01000100000100000100010101000000010
01011111010111011111010101111111010
01000001010101010000010000000101000
01111101010101110111110111110101111
01000101010000010000010100010000000
01011101110111011111011101011111010
01000000000100000100000001000000010
01111111111111111111111111111111111
